7 16
|--------------|
|..F...........|
|...|..-.......|
|..-|.@........|
|......-.......|
|.........F....|
|--------------|