7 16
|--------------|
|..............|
|...|..-.......|
|..-|.@........|
|......-.......|
|..............|
|--------------|