5 10
|----------|
|...|..-...|
|..-|.@....|
|......-...|
|----------|