7 16
|--------------|
|..F...........|
|...|..-.......|
|..-|.@...P....|
|......-.......|
|.........F....|
|--------------|